
NO ./maps/sud.xpm
SO ./maps/sud.xpm
WE ./maps/nord.xpm
EA ./maps/est.xpm 

 
F 220,100,0
C 225,30,0

     1111111111111111
    1100000111110011
    10000W01 10000011
11111000000111000011111
11111111101111111011111
11111111101111111011111
11111111101111111011111
10000000000000000000001
10000000000000000000001
10000000000000000000001
11111100000000000001111
 11111111111111111111