NO ./textures/colorstone.xpm
SO ./textures/redbrick.xpm
WE ./textures/greystone.xpm
EA ./textures/mossy.xpm



F 255, 0, 0
C 0, 0, 255

111111111111111111111111
111111111111111111111111
111111111111111111111111
111111111111111N00000111
111100001111111000000001
100000000000000000000101
111111111111111111111111
