NO	./textures/colorstone.xpm
SO	./textures/redbrick.xpm
WE	./textures/yellowstone.xpm
EA	./textures/mossy.xpm



F 255, 0, 0
C 0, 0, 255

111111111111111111111111111111111111111111111111111
1000000     0000000000000000000     11      0000001
1000000       00000000N0000000     1111     0000001
100000         00000000000000     111111   00000001
10000           000000000000       1111   000000001
1000             0000000000         11   0000000001

